NO ./textures/north.xpm                           
SO ./textures/south.xpm 
WE ./textures/west.xpm 
EA ./textures/east.xpm 

F 100,0,25
C 0,30,0

        1111111111111111111111111
        1000000000110000000000001
        1011000001110000000000001
        1001000000000000000000001
111111111011000001110000000000001
110000000011000001110111111111111
11101111111111011100000010001
11101111111111011101010010001
11000000110101011100000010001
10000000000000001100000010001
100N0000000000000110000000001
11000001110101011110111000111
11110111 1110101 101111010001
11111111 1111111 111111111111
