NO ./textures/north.xpm              
SO ./textures/south.xpm 
WE ./textures/west.xpm 
EA ./textures/east.xpm 

F 0,100,200
C 0,30,100

    1111111111
    1000000001
11111000100001
10001000011111
1000100001
1000100001
1N00100001
1000100001
1000000001
1111111111
