1111111111111111111111111
100000000000000C000000001
1010010100000000100010101
1010000000100000000000101
10000100000C0000100010101
10C001000000E000100000101
1010000100100000100010001
1010000100100000100010101
1010010100001110100010101
1010010010101010000010101
1P0C00000C00C0000000000C1
1111111111111111111111111
